level B4-S
9
9
1
3168
1440
1
true
.........
.........
.........
.........
.........
.........
.........
.......1.
.........
^^^^^^^^^
^xxx^xxx^
^x^x^x^x^
^x^xxx^x^
^x^^^^^x^
^xxx^xxx^
^^^x^x^^^
^1xx^xxx^
^^^^^^^^^
..........
..........
..........
..........
..........
..........
..........
..........
..........
.........
.........
.........
.........
.........
.........
.........
.........
.........
.........
