mainmenu
7
8
3
1
2
0
..23....
...1....
........
........
........
........
........
.#xx####
.#xx####
.#xx####
.#xx####
.#xx####
.#xx####
.#xx####
.........
.........
.........
.........
.........
.........
.........
..__....
........
........
.._.....
..._....
........
........
........