10
10
3
1.........
..........
..........
..........
..........
..........
..........
..........
..........
2........3
##########
##########
##########
##########
##########
##########
##########
##########
##########
##########
|||||||||||
|||||||||||
|||||||||||
|||||||||||
|||||||||||
|||||||||||
|||||||||||
|||||||||||
|||||||||||
|||||||||||
__________
__________
__________
__________
__________
__________
__________
__________
__________
_._._._.__
__________
